12
000XX00XXXXX
XX00000XXXXX
000000XXXXXX
0000000XXXXX
XXXXXX0XXXXX
S000000XXXXX
XXXXXXXXXXXX
XXXXXXXXXXXX
XXXXXXXXXXXX
XXXXXXXXXXXX
XXXXXXXXXXXX
XXXXXXXXXXXX