12
0000000XXXXX
000XXX0XXXXX
000XXX0XXXXX
000XXX0XXXXX
X00XXX0XXXXX
XS00000XXXXX
XXXXXXXXXXXX
XXXXXXXXXXXX
XXXXXXXXXXXX
XXXXXXXXXXXX
XXXXXXXXXXXX
XXXXXXXXXXXX