12
000X0XXXXXXX
0X0X0XXXXXXX
00000XXXXXXX
XX0X0XXXXXXX
S00X0XXXXXXX
XXXXXXXXXXXX
XXXXXXXXXXXX
XXXXXXXXXXXX
XXXXXXXXXXXX
XXXXXXXXXXXX
XXXXXXXXXXXX
XXXXXXXXXXXX