12
0XXX000XXXXX
0XXX0X0XXXXX
0000000XXXXX
0XXX0XXXXXXX
0XXX000XXXXX
0XXXXXSXXXXX
XXXXXXXXXXXX
XXXXXXXXXXXX
XXXXXXXXXXXX
XXXXXXXXXXXX
XXXXXXXXXXXX    
XXXXXXXXXXXX