12
X000000XXXXX
0000000XXXXX
00XXX00XXXXX
00XXX00XXXXX
0000000XXXXX
S00000XXXXXX
XXXXXXXXXXXX
XXXXXXXXXXXX
XXXXXXXXXXXX
XXXXXXXXXXXX
XXXXXXXXXXXX
XXXXXXXXXXXX