12
X0000000XXXX
X00X00000XXX
000X0XX00XXX
000X0XX00XXX
0XXX0XX00XXX
0XXX0XX00XXX
0XXX0XX00XXX
0XXX0XXX0XXX
000000000XXX
X0000XX00XXX
000XX00XXXXX
S000000XXXXX
