12
000XX0000XXX
0X0XX0XX0XXX
000000000XXX
XX0XX0XXXXXX
XX0000X00XXX
0000X0X00XXX
0000X0000XXX
0000XXX0XXXX
X00000X00XXX
000000X00XXX
0XXX00X00XXX
00SX00000XXX