12
X000000XXXXX
0000000XXXXX
00X00000XXXX
000000X0XXXX
000000X0XXXX
000000X0XXXX
00000000XXXX
0X0000X0XXXX
00000XX0XXXX
0X0X0XX0XXXX
0X00000SXXXX
XXXXXXXXXXXX