12
00000X000XXX
XX00000XXXXX
0000000X0XXX
0X0XX0000XXX
0X0X00000XXX
00000000XXXX
00000000XXXX
0XX000000XXX
00000000SXXX
XXXXXXXXXXXX
XXXXXXXXXXXX
XXXXXXXXXXXX
