12
000XXX00XXXX
X000X000XXXX
0000X000XXXX
0X00X000XXXX
0XX0X000XXXX
0XX0X0X0XXXX
S00000X0XXXX
XXXXXXXXXXXX
XXXXXXXXXXXX
XXXXXXXXXXXX
XXXXXXXXXXXX
XXXXXXXXXXXX