12
00XX0XXXXXXX
00000XXXXXXX
X00X00XXXXXX
000XX0XXXXXX
0X00000XXXXX
S000000XXXXX
XXXXXXXXXXXX
XXXXXXXXXXXX
XXXXXXXXXXXX
XXXXXXXXXXXX
XXXXXXXXXXXX
XXXXXXXXXXXX