12
000X000XXXXX
0000000XXXXX
0XXX000XXXXX
000000XXXXXX
XXXXX00XXXXX
000XX00XXXXX
SX00000XXXXX
XXXXXXXXXXXX
XXXXXXXXXXXX
XXXXXXXXXXXX
XXXXXXXXXXXX
XXXXXXXXXXXX