12
0000000XXXXX
00XXX0XXXXXX
0000000XXXXX
X000000XXXXX
000000XXXXXX
0000000XXXXX
00XXX00XXXXX
S000000XXXXX
XXXXXXXXXXXX
XXXXXXXXXXXX
XXXXXXXXXXXX
XXXXXXXXXXXX
