12
00X0000XXXXX
00X0XX0XXXXX
00X0XX0XXXXX
X000000XXXXX
000000XXXXXX
0XX0XXXXXXXX
0XX0XXXXXXXX
S000XXXXXXXX
XXXXXXXXXXXX
XXXXXXXXXXXX
XXXXXXXXXXXX
XXXXXXXXXXXX
